11111111111111
11001000000011
100C010CC0CC01
10CC00CCCCCCC1
1C0C000CCECC01
100C0000CCC001
110C00P00C0001
11000101000011
11111111111111