11111111111111
11001100000011
10CC000CC01C01
1000C0C1CCCCC1
100C000CCECC01
10C00000C11001
10CCC0P00C0001
11000101000011
11111111111111