11111111111111
11001100000011
10CC0101C01C01
1000C0C1C1CCC1
110C010C1ECC01
1000C000C11001
10CC00P00C0001
11000101100111
11111111111111