11111111111111
11001010E1CC11
1C000C001CC0C1
1C0C0PC0CC0C11
1CCC010011C0C1
100C00CCC00C11
110C01010110C1
110001110CCC01
11111111111111