1111111111111
1P1CE00000001
1010000000001
1111111111111