1111111111111
1PCE000000001
10-INVALID-01
1111111111111