1111111111111
1P0E000000001
1000000000001
1111111111111