1111111111111
1PC0000000001
1000000000001
1111111111111