1111111111111
10CE000000001
1000000000001
1111111111111