1111111111111
1PCE00000001
1000000000001
1111111111111